-1 -1 -1 -1 -1 -1 23 25 26 -1
-1 -1 -1 -1 -1 -1 22 -1 27 -1
0 1 -1 -1 21 20 19 -1 28 -1
-1 2 3 4 -1 -1 15 -1 29 30
-1 -1 -1 5 13 14 16 17 -1 -1
-1 -1 -1 6 -1 -1 -1 18 -1 -1
-1 -1 8 7 9 10 12 -1 -1 -1
-1 -1 -1 -1 -1 11 -1 -1 -1 -1