-1 -1 -1 -1 -1 -1 -1 -1 -1 17 -1 -1 -1 -1
-1 -1 -1 -1 -1 -1 14 13 15 16 -1 39 -1 -1
-1 -1 -1 -1 -1 -1 -1 12 -1 -1 -1 37 -1 -1
-1 0 1 2 3 4 -1 11 -1 -1 -1 36 38 -1
-1 -1 -1 -1 5 -1 -1 10 -1 33 34 35 -1 -1
-1 -1 -1 -1 6 7 8 9 -1 32 -1 -1 -1 -1
-1 -1 -1 -1 -1 -1 -1 18 19 20 29 30 31 -1
-1 -1 -1 -1 -1 -1 -1 -1 -1 21 -1 -1 -1 -1
-1 -1 -1 -1 -1 -1 -1 -1 -1 22 -1 -1 -1 -1
-1 -1 -1 -1 -1 -1 -1 -1 26 23 25 -1 -1 -1
-1 -1 -1 -1 -1 -1 -1 -1 -1 24 -1 -1 -1 -1
-1 -1 -1 -1 -1 -1 -1 -1 -1 27 -1 -1 -1 -1
-1 -1 -1 -1 -1 -1 -1 -1 -1 28 -1 -1 -1 -1